111111111111111111111111
100000000000000000000001
1P0000000000000000C00001
100000000111000E00000001
100000000001C00000000001
100000000001110000000001
100000000000010000000001
100000000000000000000001
10E00000000000C000000001
111111111111111111111111
