111111111111111111111111
100000N00000000000000001
1P00CE000010000000000001
100000000111001010000001
100000N00000000000000001
100000N00000000000000001
100000100000000000000001
100001C10000000000000001
100001N10000000000000001
100000N00000000000000001
100000N00000000000000001
100000N00000000000000001
100000N00000000000000001
100000N00000000000000001
100000N00000000000000001
100000N00000000000000001
111111111111111111111111
