111111111111111111111111111111111111111111111111
100000N000000000000000000000N0000000000000000001
1PB0CE0000100000000000000000N0000000000000000001
100000000111001010000000N00000000000000000000001
100000000111001010000000N00000000000000000000001
100000000111001010000000N00000000000000000000001
100000000111001010000000N00000000000000000000001
100000000111001010000000N00000000000000000000001
111111111111111111111111111111111111111111111111
