111111111111111111111111
100000000N10000000000001
1P000000001C000000C00001
100000000111000N00C00001
10000N000001C0000000B001
100000000001110000000001
100000000000010000000001
10N0000B000001C100000BE1
111111111111111111111111
