111111111111111111111111
100000000N00000000000001
1P000000001C000000C00001
100000000111001N10C00001
10000NC00001C0000000B001
100000000001110000000001
10000C000000100000000011
10N0000B000001C100000BE1
111111111111111111111111
