111111111111111111111111
1000000000100000C0000001
1P0000C00000000000C00001
10000C0B0111000N00C00001
10000N000001000000000001
100000B00001110000000001
1000000000000100000B0001
10N0000B00C0010100000001
10N0000B0000000100000001
10N0000B0000000100000001
10N000010000000100000001
10N000000000000100000001
10N000000000000100000001
10N000000001000100000001
10N000000000000100000001
10N000000100000100000001
10N000000000000100000001
10N000000000000100000001
10N000000000000100000001
10N000000000000100000001
10N000000100000100000001
10N000001000010100000001
10N000001000010100000001
10N000001000010100000001
10N000001000010100000001
10N000001000010100000001
10N000001000010100000001
10N000001000010100000001
10N000001000010100000001
10N000001000010100000001
10N000001000010100000001
10N000001000010100000001
10N000001000010100000001
10N0000B00000101000000E1
111111111111111111111111
