111111111111111111111111
100000000010000000000001
1P0C0E000000000000000001
1000000B0111000N00000001
10000N0B00010BB000000001
100000B00001110000000001
111111111111111111111111
