111111111111111111111111
1000010N0000000000000001
1P0C0E000000000000000001
10CCC00B01110000000000N1
1000000B00010BB000000001
100000B00001110000000001
111111111111111111111111
