111111111111111111111111
1P000C000000000000000011
111111111111111111011111
100000000111001010000001
100000000001000000000001
10000000000000000N000001
10E000B000001000000000B1
10N0000000B0010100000001
111111111111111111111111
