111111111111111111111111111111
1P00000001000C00C0000C00000E01
101111110101111110111111011101
100000010C0000C100000100000001
101111011111011111111011111101
100000010N00C100000100000N0001
111110111110111110111110111111
10N000001000000N001000N0000001
10B0C00000100B0C00001000000001
111111111111111111111111111111
